....................
....................
....................
....................
....................
....................
....................
.........GGG........
.........###........
....................
....GGG.......GGG...
....#############...
....................
.1GGGGGGGGGGGGGGGGX.
####################
